0,0,0,0,0,0,0,65,0,0,0,0,0,0,65,0,65,0,0,0,0,
0,0,0,0,0,0,0,67,0,0,0,0,0,0,68,0,68,0,0,0,66,
3,65,68,0,0,1,2,2,2,2,3,0,0,1,2,2,3,0,0,1,2,
12,2,3,0,0,0,0,0,0,0,0,0,0,0,0,0,0,0,0,0,0,
0,0,0,0,0,0,0,0,0,0,1,2,3,0,0,0,0,0,0,0,0,
0,0,0,0,0,0,0,0,0,65,0,0,0,0,0,0,0,0,0,0,0,
0,0,0,0,0,0,1,3,0,0,0,0,0,0,0,0,0,67,73,67,0,
0,0,1,3,0,0,0,0,0,0,0,0,1,2,3,0,1,2,2,2,2,
0,0,0,0,0,65,0,0,0,1,3,0,0,0,0,0,0,0,0,0,0,
65,0,0,0,0,0,0,0,0,0,0,0,0,0,65,0,0,0,70,0,0,
8,0,0,0,0,1,2,3,0,0,0,0,69,0,0,0,0,0,67,0,1,
0,0,0,0,0,0,0,0,0,0,0,1,2,2,3,0,0,1,2,2,13,
0,1,3,0,0,0,0,0,0,65,0,0,0,0,0,0,0,0,0,0,0,
0,0,0,0,0,0,0,0,0,0,0,0,0,67,0,0,0,0,0,0,68,
0,0,65,0,0,0,0,0,1,3,0,0,1,2,2,3,0,0,1,2,2,
0,0,0,0,0,1,3,0,0,0,0,0,0,0,0,0,0,0,0,0,0,
0,1,2,3,0,0,0,0,0,0,0,1,2,2,3,0,0,0,0,0,0,
0,0,0,0,0,0,0,8,0,0,0,0,0,0,0,0,0,0,1,3,0,
8,0,65,0,0,0,0,0,0,0,65,0,0,65,0,0,0,0,0,0,0,
0,0,0,65,0,0,0,0,67,67,73,0,0,69,0,0,0,0,0,0,0,
0,1,2,2,3,0,0,1,2,2,3,0,1,2,3,0,0,1,3,0,0