0,0,0,0,0,0,0,0,0,0,0,0,0,0,0,0,0,0,0,0,0,
0,0,0,0,0,0,0,0,0,0,0,0,0,0,0,0,0,0,0,0,0,
0,0,0,0,0,0,0,0,0,0,0,0,0,0,0,0,0,0,0,0,0,
0,0,0,0,0,0,0,0,0,0,0,0,0,0,0,0,0,0,0,0,0,
0,0,0,0,0,0,0,0,0,0,0,0,0,0,0,0,0,0,0,0,0,
0,0,0,0,0,0,0,0,0,0,0,0,0,0,0,0,0,0,0,0,0,
0,0,0,0,0,0,0,0,0,0,0,0,0,0,0,0,0,0,0,0,0,
0,0,0,0,0,0,0,0,0,26,26,26,0,0,0,0,0,0,0,0,0,
0,0,0,0,0,0,0,0,0,26,26,26,0,0,0,0,0,0,0,0,0,
0,0,0,0,0,0,0,0,0,26,26,26,0,0,0,0,0,0,0,0,0,
0,0,0,0,0,0,0,0,0,26,26,26,0,0,0,0,0,0,0,0,0,
0,0,0,0,0,0,0,0,0,26,26,26,0,0,0,0,0,0,0,0,0,
0,0,0,0,0,0,0,0,0,26,26,26,0,0,0,0,0,0,0,0,0,
0,0,0,0,0,0,0,0,0,26,26,26,0,0,0,0,0,0,0,0,0,
0,0,0,0,0,0,0,0,0,26,26,26,0,0,0,0,0,0,0,0,0,
0,0,0,0,0,0,0,0,0,26,17,26,0,0,0,0,0,0,0,0,0,
0,0,0,0,0,0,0,0,0,26,3,26,0,0,0,0,0,0,0,0,0,
0,0,0,0,0,0,0,0,0,26,3,26,0,0,0,0,0,0,0,0,0,
0,0,0,0,0,26,0,0,0,26,3,26,0,0,0,26,26,0,0,0,0,
0,0,0,0,0,26,0,0,0,26,3,26,0,28,0,26,26,0,27,0,0,
0,0,16,17,18,26,16,17,18,26,3,26,16,17,18,26,26,16,17,18,0